0
5
 43  43 153 204 225  272 145 0 0
 40  60  69  79 161 1043 557 0 0
292 146 239  65  61  580 231 0 0
200  77 212 113  26  813 523 0 0
100  77 153 153 153  426 608 0 0
0
0