0
5
  0  43 153 204 225 272 145 0 0
  0  60  69  79 161 957 266 0 0
  0 146 239  65  61 614 214 0 0
241 120 212 113  26 671 583 0 0
  0  77 153 153 153 289 488 0 0
0