0
5
 43  43 153 204 225  372 145 0 0
 60  60  69  79 161 1057 266 0 0
300 146 239  65  61  714 214 0 0
241 120 212 113  26  771 583 0 0
100  77 153 153 153  289 488 0 0
0