0
5
 43  43 153 204 225 272 145 0 0
 50  60  69  79 161 957 266 0 0
300 146 239  65  61 614 214 0 0
241 120 212 113  26 671 583 0 0
100  77 153 153 153 289 488 0 0
0